~~~~~~~~~~~~~~~~~~~~~~~~~~~~~~~~~~~~~~~~~~~~~~~~~~~~~~~~~~~~
~~~~~~~~~~~~~~~~~~~~~~~~~~~~~~~~~~~~~~~~~~~~~~~~~~~~~~~~~~~~
~~~~~~~~~~~~~~~~~~~~~~~~~~~~~~~~~~~~~~~~~~~~~~~~~~~~~~~~~~~~
~~80000000000000000000000000000000000000000000000000009~~~~~
~~81111111111111111111111111111111111111111111111111119~~~~~
~~81111111111111111111111111111111111111111111111111119~~~~~
~~81111111111111111111111111111111111111111111111111119~~~~~
~~81111111111111111111111111111111111111111111111111119~~~~~
~~eooooooof1111111goooooooooooooooooooooooooofoooooogoa~~~~~
~~~~~~~~~~811111119~~~~~~~~~~~~~~~~~~~~~~~~~~81111119~~~~~~~
~~~~~~~~~~811111119~~~~~~~~~~~~~~~~~~~~~~~~~~81111119~~~~~~~
~~~~~~~~~~811111119~~~~~~~~~~~~~~~~~~~~~~~~~~81111119~~~~~~~
~~~~~~~~~~811111119~~~~~~~~~~~~~~~~~~~~~~~~~~81111119~~~~~~~
~~~~~~~~~~811111119~~~~~~~~~~~~~~~~~~~~~~~~~~81111119~~~~~~~
~~~~~~~~~~811111119~~~~~~~~~~~~~~~~~~~~~~~~~~81111119~~~~~~~
~~~~~~~~~~811111119~~~~~~~~~~~~~~~~~~~~~~~~~~81111119~~~~~~~
~~~~~~~~~~811111119~~~~~~~~~~~~~~~~~~~~~~~~~~81111119~~~~~~~
~~~~~~~~~~811111119~~~~~~~~~~~~~~~~~~~~~~~~~~81111119~~~~~~~
~~~~~~~~~~811111119~~~~~~~~~~~~~~~~~~~~~~~~~~81111119~~~~~~~
~~~~~~~~~~811111119~~~~~~~~~~~~~~~~~~~~~~~~~~81111119~~~~~~~
~~~~~~~~~~81111111e00000000000000000000000000e111111a000009~
~~~~~~~~~~8111111111111111111111111111111111111111111111119~
~~~~~~~~~~8111111111111111111111111111111111111111111111119~
~~~~~~~~~~1111111111111111111111111111111111111111111111119~
~~~~~~~~~~8ooooooooooooooooooe11111111111111111111111111119~
~~~~~~~~~~~~~~~~~~~~~~~~~~~~~811111111111111111111111111119~
~~~~~~~~~~~~~~~~~~~~~~~~~~~~~811111111111111111111111111119~
~~~~~~~~~~~~~~~~~~~~~~~~~~~~~eooooooooooooooooooooooooooooa~
~~~~~~~~~~~~~~~~~~~~~~~~~~~~~~~~~~~~~~~~~~~~~~~~~~~~~~~~~~~~
;