~~~~~~~~~~~~~~~~~~~~~~~~~~~~~~~~~~~~~~~~~~~~~~~~~~~~~~~~~~~~
~~~~~~~~~~~~~~~~~~~~~~~~~~~~~~~~~~~~~~~~~~~~~~~~~~~~~~~~~~~~
~~~~~~~~~~~~~~~~~~~~~~~~~~~~~~~~~~~~~~~~~~~~~~~~~~~~~~~~~~~~
~~~~~~~~~~~~~~~~~~~~~~~~~~~~~~~~~~~~~~~~~~~~~~~~~~~~~~~~~~~~
~~~~~~~~~~~~800000000000000000000009~~~~~~~~~~~~~~~~~~~~~~~~
~~~~~~~~~~~~811111111111111111111119~~~~~~~~~~~~~~~~~~~~~~~~
~~~~~~~~~~~~811111111111111111111119~~~~~~~~~~~~~~~~~~~~~~~~
~~~~~~~~~~~~811111111111111111111119~~~~~~~~~~~~~~~~~~~~~~~~
~~~~~~~~~~~~811111111111111111111119~~~~~~~~~~~~~~~~~~~~~~~~
~~~~~~~~~~~~811111111111111111111119~~~~~~~~~~~~~~~~~~~~~~~~
~~~~~~~~~~~~811111111111111111111119~~~~~~~~~~~~~~~~~~~~~~~~
~~~~~~~~~~~~811111111111111111111119~~~~~~~~~~~~~~~~~~~~~~~~
~~~~~~~~~~~~811111111111111111111119~~~~~~~~~~~~~~~~~~~~~~~~
~~~~~~~~~~~~811111111111111111111119~~~~~~~~~~~~~~~~~~~~~~~~
~~~~~~~~~~~~811111111111111111111119~~~~~~~~~~~~~~~~~~~~~~~~
~~~~~~~~~~~~eooooooooooooooooooooooa~~~~~~~~~~~~~~~~~~~~~~~~
~~~~~~~~~~~~~~~~~~~~~~~~~~~~~~~~~~~~~~~~~~~~~~~~~~~~~~~~~~~~
~~~~~~~~~~~~~~~~~~~~~~~~~~~~~~~~~~~~~~~~~~~~~~~~~~~~~~~~~~~~
~~~~~~~~~~~~~~~~~~~~~~~~~~~~~~~~~~~~~~~~~~~~~~~~~~~~~~~~~~~~
~~~~~~~~~~~~~~~~~~~~~~~~~~~~~~~~~~~~~~~~~~~~~~~~~~~~~~~~~~~~
~~~~~~~~~~~~~~~~~~~~~~~~~~~~~~~~~~~~~~~~~~~~~~~~~~~~~~~~~~~~
~~~~~~~~~~~~~~~~~~~~~~~~~~~~~~~~~~~~~~~~~~~~~~~~~~~~~~~~~~~~
~~~~~~~~~~~~~~~~~~~~~~~~~~~~~~~~~~~~~~~~~~~~~~~~~~~~~~~~~~~~
~~~~~~~~~~~~~~~~~~~~~~~~~~~~~~~~~~~~~~~~~~~~~~~~~~~~~~~~~~~~
~~~~~~~~~~~~~~~~~~~~~~~~~~~~~~~~~~~~~~~~~~~~~~~~~~~~~~~~~~~~
~~~~~~~~~~~~~~~~~~~~~~~~~~~~~~~~~~~~~~~~~~~~~~~~~~~~~~~~~~~~
~~~~~~~~~~~~~~~~~~~~~~~~~~~~~~~~~~~~~~~~~~~~~~~~~~~~~~~~~~~~
~~~~~~~~~~~~~~~~~~~~~~~~~~~~~~~~~~~~~~~~~~~~~~~~~~~~~~~~~~~~
~~~~~~~~~~~~~~~~~~~~~~~~~~~~~~~~~~~~~~~~~~~~~~~~~~~~~~~~~~~~

;