~~~~~~~~~~~~~~~~~~~~~~~~~~~~~~~~~~~~~~~~~~~~~~~~~~~~~~~~~~~~
~~~~~~~~~~~~~~~~~~~~~~~~~~~~~~~~~~~~~~~~~~~~~~~~~~~~~~~~~~~~
~~~~~~~~~~~~~~~~~~~~~~~~~~~~~~~~~~~~~~~~~~~~~~~~~~~~~~~~~~~~
~~~~~~800000000000000000000000000000000000000000009~~~~~~~~~
~~~~~~811111111111111111111111111111111111111111119~~~~~~~~~
~~~~~~811111111111111111111111111111111111111111119~~~~~~~~~
~~~~~~811111111111111111111111111111111111111111119~~~~~~~~~
~~~~~~811111111111111111111111111111111111111111119~~~~~~~~~
~~~~~~811111111111111111111111111111111111111111119~~~~~~~~~
~~~~~~811111111111111111111111111111111111111111119~~~~~~~~~
~~~~~~811111111111111111111111111111111111111111119~~~~~~~~~
~~~~~~811111111111111111111111111111111111111111119~~~~~~~~~
~~~~~ 811111111111111111111111111111111111111111119~~~~~~~~~
~~~~~~811111111111111111111111111111111111111111119~~~~~~~~~
~~~~~~811111111111111111111111111111111111111111119~~~~~~~~~
~~~~~~811111111111111111111111111111111111111111119~~~~~~~~~
~~~~~~811111111111111111111111111111111111111111119~~~~~~~~~
~~~~~~811111111111111111111111111111111111111111119~~~~~~~~~
~~~~~~811111111111111111111111111111111111111111119~~~~~~~~~
~~~~~~811111111111111111111111111111111111111111119~~~~~~~~~
~~~~~~811111111111111111111111111111111111111111119~~~~~~~~~
~~~~~~811111111111111111111111111111111111111111119~~~~~~~~~
~~~~~~811111111111111111111111111111111111111111119~~~~~~~~
~~~~~~eoooooooog1111111fooooooooooooooooooooooooooa~~~~~~~~~
~~~~~~~~~~~~~~~811111119~~~~~~~~~~~~~~~~~~~~~~~~~~~~~~~~~~~~
~~~~~~~~~~~~~~~811111119~~~~~~~~~~~~~~~~~~~~~~~~~~~~~~~~~~~~
~~~~~~~~~~~~~~~811111119~~~~~~~~~~~~~~~~~~~~~~~~~~~~~~~~~~~~
~~~~~~~~~~~~~~~eoooooooa~~~~~~~~~~~~~~~~~~~~~~~~~~~~~~~~~~~~
~~~~~~~~~~~~~~~~~~~~~~~~~~~~~~~~~~~~~~~~~~~~~~~~~~~~~~~~~~~~
;