~~~~~~~~~~~~~~~~~~~~~~~~~~~~~~~~~~~~~~~~~~~~~~~~~~~~~~~~~~~~
~~~~~~~~~~~~~~~~~~~~~~~~~~~~~~~~~~~~~~~~~~~~~~~~~~~~~~~~~~~~
~~~~~~~~~~~~~~~~~~~~~~~~~~~~~~~~~~~~~~~~~~~~~~~~~~~~~~~~~~~~
~~~~~~~~~~~~~~~~~~~~~~~~~~~~~~~~~~~~~~~~~~~~~~~~~~~~~~~~~~~~
~~~~~8000009~~~~~~~~~~~~~~~~~~~~~~~~~~~~~~~~~~~~~~~~~~~~~~~~
~~~~~8111119~~~~~~~~~~~~~~~~~~~~~~~~~~~~~~~~~~~~~~~~~~~~~~~~
~~~~~8111119~~~~~~~~~~~~~~~~~~~~~~~~~~~~~~~~~~~~~~~~~~~~~~~~
~~~~~8111119~~~~~~~~~~~~~~~~~~~~~~~~~~~~~~~~~~~~~~~~~~~~~~~~
~~~~~8111119~~~~~~~~~~~~~~~~~~~~~~~~~~~~~~~~~~~~~~~~~~~~~~~~
~~~~~8111119~~~~~~~~~~~~~~~~~~~~~~~~~~~~~~~~~~~~~~~~~~~~~~~~
~~~~~8111119~~~~~~~~~~~~~~~~~~~~~~~~~~~~~~~~~~~~~~~~~~~~~~~~
~~~~~811111a00000000000000000000000000000000000009~~~~~~~~~~
~~~~~811111111111111111111111111111111111111111119~~~~~~~~~~
~~~~~811111111111111111111111111111111111111111119~~~~~~~~~~
~~~~~811111111111111111111111111111111111111111119~~~~~~~~~~
~~~~~811111111111111111111111111111111111111111119~~~~~~~~~~
~~~~~811111111111111111111111111111111111111111119~~~~~~~~~~
~~~~~811111111111111111111111111111111111111111119~~~~~~~~~~
~~~~~811111111111111111111111111111111111111111119~~~~~~~~~~
~~~~~811111111111111111111111111111111111111111119~~~~~~~~~~
~~~~~811111111111111111111111111111111111111111119~~~~~~~~~~
~~~~~811111111111111111111111111111111111111111119~~~~~~~~~~
~~~~~811111111111111111111111111111111111111111119~~~~~~~~~~
~~~~~811111111111111111111111111111111111111111119~~~~~~~~~~
~~~~~811111111111111111111111111111111111111111119~~~~~~~~~~
~~~~~811111111111111111111111111111111111111111119~~~~~~~~~~
~~~~~811111111111111111111111111111111111111111119~~~~~~~~~~
~~~~~eoooooooooooooooooooooooooooooooooooooooooooa~~~~~~~~~~
~~~~~~~~~~~~~~~~~~~~~~~~~~~~~~~~~~~~~~~~~~~~~~~~~~~~~~~~~~~~
;