~~~~~~~~~~~~~~~~~~~~~~~~~~~~~~~~~~~~~~~~~~~~~~~~~~~~~~~~~~~~
~~~~~~~~~~~~~~~~~~~~~~~~8000000000000000000000000000000009~~
~~~~~~~~~~~~~~~~~~~~~~~~8111111111111111111111111111111119~~
~~~~~~~~~~~~~~~~~~~~~~~~8111111111111111111111111111111119~~
~~~~~~~~~~~~~~~~~~~~~~~~8111111111111111111111111111111119~~
~~~~~~~~~~~~~~~~~~~~~~~~8111111111111111111111111111111119~~
~~~~~~~~~~~~~~~~~~~~~~~~811111111111gooooooooooooooooooooa~~
~~~~~~~~~~~~~~~~~~~~~~~~8111111111119~~~~~~~~~~~~~~~~~~~~~~~
~~~~~~~~~~~~~~~~~~~~~~~~8111111111119~~~~~~~~~~~~~~~~~~~~~~~
~~~~~~~~~~~~~~~~~~~~~~~~8111111111119~~~~~~~~~~~~~~~~~~~~~~~
~~~~~~~~~~~~~~~~~~~~~~~~8111111111119~~~~~~~~~~~~~~~~~~~~~~~
~~~~~80000000000000000008111111111119~~~~~~~~~~~~~~~~~~~~~~~
~~~~~81111111111111111111111111111119~~~~~~~~~~~~~~~~~~~~~~~
~~~~~81111111111111111111111111111119~~~~~~~~~~~~~~~~~~~~~~~
~~~~~81111111111111111111111111111119~~~~~~~~~~~~~~~~~~~~~~~
~~~~~81111111111111111111111111111119~~~~~~~~~~~~~~~~~~~~~~~
~~~~~81111111111111111111111111111119~~~~~~~~~~~~~~~~~~~~~~~
~~~~~81111111111111111111111111111119~~~~~~~~~~~~~~~~~~~~~~~
~~~~~81111111111111111111111111111119~~~~~~~~~~~~~~~~~~~~~~~
~~~~~81111111111111111111111111111119~~~~~~~~~~~~~~~~~~~~~~~
~~~~~81111111111111111111111111111119~~~~~~~~~~~~~~~~~~~~~~~
~~~~~81111111111111111111111111111119~~~~~~~~~~~~~~~~~~~~~~~
~~~~~81111111111111111111111111111119~~~~~~~~~~~~~~~~~~~~~~~
~~~~~81111111111111111111111111111119~~~~~~~~~~~~~~~~~~~~~~~
~~~~~81111111111111111111111111111119~~~~~~~~~~~~~~~~~~~~~~~
~~~~~81111111111111111111111111111119~~~~~~~~~~~~~~~~~~~~~~~
~~~~~81111111111111111111111111111119~~~~~~~~~~~~~~~~~~~~~~~
~~~~~eooooooooooooooooooooooooooooooa~~~~~~~~~~~~~~~~~~~~~~~
~~~~~~~~~~~~~~~~~~~~~~~~~~~~~~~~~~~~~~~~~~~~~~~~~~~~~~~~~~~~
;